  R    R    
          
JJ VVVV JJ
JJ VVVV JJ
JJ      JJ
OO      OO
OOOO  OOOO
OOOO  OOOO
          

 BB BB BB 