BBBBBBBBBB
BVVVVVVVVB
BVJJJJJJVB
BVJOOOOJVB
BVJORROJVB
BVJORROJVB
BVJOOOOJVB
BVJJJJJJVB
BVVVVVVVVB
BBBBBBBBBB