R VVVVVV R
OR VVVV RO
 OR VV RO
B OR  RO J
BB ORRO JJ
BB ORRO JJ
B OR  RO J
 OR    RO 
OR      RO
R        R